####################################################################################################
####################################################################################################
####################################################################################################
####################################################################################################
####################################################################################################
################################FFFFFFFFF###########################################################
################################FFFFFFFFF###########################################################
######################FFFFFFFFFFFFFFFFFFF#FFFFFFFFF#################################################
######################FFFFFFFFFFFFFFF#DDD#FFFFFFFFF#################################################
######################FFFFFFFFFFFFFFF#FFFFFFFFFFFFF#FFFFFFFFFFFFFFFFFFFFF###########################
######################################FFF######DDD##FFFFFFFFFFFFFFFFFFFFF###########################
################################FFFFFDFFF#FFFFFFFFFFFFFFFFFFFFFFFFFFFFFFF###########################
################################FFFFFDFFF#FFFFFFFFFFFFFFFFFFFFFFFFFFFFFFF###########################
################################FFFFF################################DDDDDFFFF######################
################################FFFFFFFFF############################FFFFFFFFF######################
################################FFFFFFFFF############################FFFFFFFFF######################
###########################FFFF#FFFFFFFFF#FFFFFFFFFFFFFFFF###########FFFFFFFFF######################
###########################FFFF#FFFFFFFFF#FFFFFFFFFFFFFFFF###########FFFFFFFFF######################
###########################FFFF#FFFFFFFFF#FFFFFFFFFFFF###############FFFFFFFFF######################
###########################FFFFFFFFFFFFFF#FFFFFFFFFFFFDFFFFFFFFFFFFFFFFFFFFFFF######################
###########################FFFFFFFFFFFFFFFFFFFFFFFFFFFDFFFFFFFFFFFFFFFFFFFFFFF######################
###########################FFFFFFFFFFFFFFFFFFFFFFFFFFF###############FFFFFFFFF######################
###########################FFFFFFFFFFFFFFFFFFFFFFFFFFFFFFF###########FFFFFFFFF######################
###########################FFFFFFFFFFFFFFFFFFFFFFFFFFFFFFF###########FFFFFFFFF######################
#####################################################################FFFFFFFFF######################
####################################################################################################
####################################################################################################
####################################################################################################
