###############################E#############
#FFFFFFFF#FFFFFFFFFFFFFFFFC#FFFFFFFFFFFFFFFF#
#FFFSFFFF#FCFFFFFFFFFFFFFFF#FFFFFFFFFFFFFFFF#
#FFFFFFFF#FFFFFFFF#FFFFFFFF#FFFFFFF#FFFFFFFF#
#FFFFFFFF#FFFFFFFF#FFFFFPFF#FFFFFFF#FFFFFFFC#
#FFFFFFFF#FFFFFFFF#FFFFFFFF#FFFFFFF#FFFFFFFF#
#CFFFFFFF#FFFFFFFF#FFFFFFFF#FCFFFFF#CFFFFFFF#
#FFFFFFFF#FFFFFFFF#FFFFFFFF#FFFFFFF#FFFFFFFF#
#FFFFFCFF#FFFFFFFF#FFFFFFFF#FFFFFFF#FFFFFFPF#
#FPFFFFFF#CFFFFFFF#CFFFFFFF#FFFFFFF#FFFFFFFF#
#FFFFFFFF#FFFFFFFF#FFFFFFFF#FFFFFFF#FFFFFFFF#
#FFFFFFFFFFFFFFFFF#FFFFFFFFFFFFFFFC#FFFFFFFF#
#FFFFFFFFFFFFFFFFF#FFFFFFFFFFFFFFFF#FFFFFFFF#
#############################################
